WE assets/carulcuboi.png

SO assets/coloanainfinitului.png

NO assets/monalisa.png
EA assets/coloanainfinitului.png



F 245,222,179
C 135,206,235

1111111111111111111111111
1000000000000000000000001
100000000000N000000000001
1000000000000000000000001
1111111111111111111111111
